

NO ./texture/north
SO ./texture/south 
WE ./texture/west
EA ./texture/east

F 220,100,10
C 225,30,10        


1111
1N01
1111