NO ./north
SO ./south 
WE ./west
EA ./east
F 220,100,10
C 225,30,10        


        1111111111111111111111111
        10000000001100000000000011
        1011000001110000000000001
        1001000000000000000000001
111111111011000001110000000000001    111111
100000000011000001110111111111111
11110111111111011   1100000010001
11110111111111011    1101010010001
1100000011010101111111100000010001
1000000000000000110000001000111111
10000000000000001101010010001
11000001110101011111011110N0111
11110111 1110101 101111010001
11111111 1111111 111111111111     
