NO ./north
SO ./south 
WE ./west
EA ./east
F 220,100,10
C 225,30,10        

11 11 11
11111
10001                                               
11N11
1 111 1  11111
